111111
1P0001
100001
10C001
10E001
111111





