11111111111111111111
100E0P00100000M10011
11111111111111111111