111111
1C0101
1C0001
10E101
10P001
111111