1111
1001
1001
1111
1111
1E01
1CP1
1011
1111