1111
1001
1001
1E01
10P1
10C1
1111