1111
1C01
1C01
1E01
10P1
1111
