11111111111111111111
1C100M0C01011C01C011
1C00000C00010C00C001
10010P00010000010011
1000010000010C00E001
11111111111111111111