1111111111111
10P000E000001
1000C0C00M001
1111111111111
