1111111111111111111111111111111
1C00000C00000C00000C00000C00001
10M0010000010C0001000CP10E00011
1111111111111111111111111111111