11111111111111111111
10100M00010110010011
1000000000010C00C001
10010PE0010000010011
1000010000010C000001
11111111111111111111