1111111111111111111111111111
1111111001111111111001111111
1111100011111001111100011111
1110000011110000111100000111
110000C0011100001110000E0011
1100000000000000000000000011
1000000000000CC0000000C00001
100C000P00000CC000000000C001
1100000000000000000000000011
11000011000100M0100011000011
1110011111111001111111100111
1111001111111001111111001111
1111111111111111111111111111