1111111
1EM0CP1
1000001
1111111