111111111111111111111111111111111111111111
1C00000C00000C00000C000E0C00000C00000C0001
1001000001M0000100000100000100000100000101
110001110011001110001111001111100111110011
1000010000010C0001000CP1000001000001000001
111111111111111111111111111111111111111111