1111111
1M0CP11
10000E1
1111111