1111111111111111111111111111111111111111111111111111111111
1100000000000000000000001111111111111111111111111111111111
1100000000000000000000001111111111111111111111111111111111
1100000000000000000000001111111111111111111111111111111111
1100011100000000011100001111111111111100000000000000000011
11000111000000000111000011111111111111000P0000000000000011
1100011100000000011100001111111111111100000000000000000011
1100011100000000011100001111111111111111111111110000000011
11000111000000000111000011111111111111111111111100000C0011
1100011111111111111100001111111111111111111111110000000011
1100011111111111111110001111111111111100000000000011111111
1100000000000000011100001111111111111100000C00000011111111
1100000000000000011100001111111111111100000000000011111111
1100000000000000011100001111111111111100000C00000000E00011
1100000000000000011100001111111111111100000000000000000011
1100000000000000011100001111111111111100000000000000000011
1100000000000000000000001111111111111111111111111111111111
1111111111111111111111111111111111111111111111111111111111