1111111
1EM0CP1
1111111
1111111