1111111111111111111111111111
1111111001111111111001111111
1111100011111001111100011111
1110000011110000111100000111
110C00C0011100001110000E0011
1100000000000C00000000000011
1000000000000C0000000C000001
100000P000000C0000000000C001
110C000000000000000000000011
1100001100010000100011000011
1110011111111001111111100111
1111001111111001111111001111
1111111111111111111111111111