111111111111111
100000000M00011
100000000000011
100P0C000001111
100000000001E11
111111111111111