1111111
1M1ECP1
1111111
1111110