1111111
1E00CP1
1111111
111M111
1111111