111111111111111111111111111111111111111111
1C01000C01000C01000C01000C01000C01000C0101
1C00000C00000C00000C000E0C00000C00000C0001
1001000001M0000100000100000100000100000101
100000000000000000000000000000000000000001
110001110011001110001111001111100111110011
1C01011C01011C01010C01010C01010C01010C0101
1C00000C00010C00010C00000C00010C00010C0001
100101000100000100000101000101000101000101
1000010000010C0001000CP1000001000001000001
111111111111111111111111111111111111111111