1111111111111111111111111111111
1C00000C00000C00000C00001110001
10M0010000010C0E01000CP11C10011
1111111111111111111111111111111