111111111111111111111111111111111111111111
111111111111000000111111111100000001111111
111111111111011110111111110001111110001111
111111111110111110111111100111111111100111
111111111100111110111111001111111111110011
111111111101111110111111011111000111111011
111111111011111110111110111110011001111001
111111110011111110111110111101111100111101
111111110111011110111110111101111110111101
111111101111011110111110000001111110111101
111111001110011110111111111011111110111101
111111011100011110111111111111111101111101
111110111101011110111111111111111101111011
111100111011011110111111111111111011111011
111101110011011110111111111111110111110111
111011110111011110111111111111101111100111
110011101111011110111111111111011111101111
110111001111011110111111111110111111011111
101111000000011110000111111101111110111111
101111111111111111110111111011111001111111
101111111111111111110111110111110011111111
101111111111111111110111101111100111111111
101111111111111111110111001111101111111111
1000000000000111100C00P0011111000000000001
111111111111011110111110111111111111111101
111111111111011110111110111111111111111101
111111111111011110111100111111111111111101
11111111111101111E111101111111111111111101
111111111111000000111100000000000000000001
111111111111111111111111111111111111111111
111111111111111111111111111111111111111111
111111111111111111111111111111111111111111