11111111111111111111111111111111111111111111111111111111111
11000000000000000000000011111111111111111111111111111111111
11000000000000000000000011111111111111111111111111111111111
11000000000000000000000011111111111111111111111111111111111
11000111000000000111000011111111111111000000000000000000111
11000111000000000111000011111111111111000P00000000000000111
11000111000000000111000011111111111111000000000000000000111
11000111000000000111000011111111111111111111111100000000111
11000111000000000111000011111111111111111111111100000C00111
11000111111111111111000011111111111111111111111100000000111
11000111111111111111100011111111111111000000000000111111111
1100000000000000011100001111111111111100000C000000111111111
11000000000000000111000011111111111111000000000000111111111
1100000000000000011100001111111111111100000C00000000E000111
11000000000000000111000011111111111111000000000000000000111
11000000000000000111000011111111111111000000000000000000111
11000000000000000000000011111111111111111111111111111111111
11111111111111111111111111111111111111111111111111111111111